1*11111
1000011
1011111
1000001
1111101
1011101
1011101
1000001
1110111
1000001
1111011
1111011
.010001
1010111
1010111
1000011
1111011
1000011
1111111
